SUA_CODE_2016,M_0_299_DS_DS_Sept_house,M_0_299_DS_DS_sd_row_tce_hs_t,M_0_299_DS_DS_Flat_apart,M_0_299_DS_DS_Other_dwg,M_0_299_DS_ns,M_0_299_Tot,M_300_449_DS_Separate_hse,M_300_449_DS_sd_row_tc_hse_th,M_300_449_DS_Flat_apart,M_300_449_DS_Other_dwg,M_300_449_DS_ns,M_300_449_Tot,M_450_599_DS_Separate_hse,M_450_599_DS_sd_row_tce_hs_th,M_450_599_DS_Flat_apart,M_450_599_DS_Other_dwg,M_450_599_DS_ns,M_450_599_Tot,M_600_799_DS_Separate_hse,M_600_799_DS_sd_row_tc_hs_th,M_600_799_DS_Flat_apart,M_600_799_DS_Other_dwg,M_600_799_DS_ns,M_600_799_Tot,M_800_999_DS_Separate_hse,M_800_999_DS_sd_row_tc_hs_th,M_800_999_DS_Flat_apart,M_800_999_DS_Other_dwg,M_800_999_DS_ns,M_800_999_Tot,M_1000_1399_DS_Separate_hse,M_1000_1399_DS_sd_rw_tc_h_th,M_1000_1399_DS_Flat_apart,M_1000_1399_DS_Other_dwg,M_1000_1399_DS_ns,M_1000_1399_Tot,M_1400_1799_DS_Separate_hse,M_1400_1799_DS_sd_rw_tc_h_th,M_1400_1799_DS_Flat_apart,M_1400_1799_DS_Other_dwg,M_1400_1799_DS_ns,M_1400_1799_Tot,M_1800_2399_DS_Separate_hse,M_1800_2399_DS_sd_rw_tc_h_th,M_1800_2399_DS_Flat_apart,M_1800_2399_DS_Other_dwg,M_1800_2399_DS_ns,M_1800_2399_Tot,M_2400_2999_DS_Separate_hse,M_2400_2999_DS_sd_rw_tc_h_th,M_2400_2999_DS_Flat_apart,M_2400_2999_DS_Other_dwg,M_2400_2999_DS_ns,M_2400_2999_Tot,M_3000_3999_DS_Separate_hse,M_3000_3999_DS_sd_rw_tc_h_th,M_3000_3999_DS_Flt_apart,M_3000_3999_DS_Other_dwg,M_3000_3999_DS_ns,M_3000_3999_Tot,M_4000_over_DS_Separate_hse,M_4000_ov_DS_sd_rw_tce_hs_th,M_4000_over_DS_Flat_apart,M_4000_over_DS_Other_dwg,M_4000_DS_over_ns,M_4000_over_Tot,Mort_Rpmnt_ns_DS_Separat_hs,Mrt_Rpmt_ns_DS_sd_rw_tc_hs_th,Mrt_Rpmt_ns_DS_Flat_apart,Mort_Rpmnt_ns_DS_Other_dwg,Mort_Rpmnt_ns_DS_ns,Mort_Rpmnt_ns_Total,Tot_DS_Separate_hse,Tot_DS_sd_row_tce_hse_thse,Tot_DS_Flat_apartment,Tot_DS_Other_dwg,Tot_DS_ns,Tot_Tot
1000,6670,111,49,78,76,6992,3615,76,47,37,26,3794,3338,53,39,40,32,3496,6403,82,74,78,43,6685,8606,118,72,72,66,8931,19583,276,165,166,140,20337,17264,202,85,128,99,17781,17776,166,72,111,136,18258,7911,66,20,45,43,8097,6652,43,31,46,26,6801,4015,16,13,43,60,4143,5872,64,40,49,59,6081,107705,1279,694,894,807,111384
1001,424,21,0,0,0,450,252,30,4,0,0,282,222,27,3,0,0,251,507,58,4,0,0,573,790,76,12,0,5,886,2511,133,15,3,7,2664,2423,53,4,0,5,2488,1859,24,4,0,7,1888,506,13,0,0,10,527,342,9,0,3,4,355,164,0,0,0,3,175,398,18,3,0,0,427,10409,456,39,10,43,10962
1002,102,0,0,0,0,109,51,0,0,0,0,51,56,0,0,0,0,55,96,7,0,0,0,103,139,6,3,0,0,152,464,15,4,0,3,483,430,8,0,0,0,449,335,4,0,0,3,344,112,0,0,0,0,112,107,3,0,0,0,114,54,0,0,0,0,57,76,0,0,0,0,81,2023,48,16,0,3,2091
1003,105,35,6,0,0,148,57,15,3,0,0,78,31,13,0,0,0,45,57,19,3,4,0,77,89,33,7,0,0,132,222,98,20,4,0,337,272,103,24,0,3,399,413,91,7,0,0,517,184,44,10,0,0,237,144,26,3,0,0,177,85,12,3,0,3,103,64,16,0,0,3,87,1725,505,83,3,9,2329
1004,98,5,6,0,0,114,45,3,6,0,0,52,42,0,0,0,0,43,60,0,4,0,0,65,87,3,3,0,0,95,244,16,14,0,0,268,256,13,3,0,3,276,273,5,3,0,3,286,80,3,0,0,0,84,61,0,0,0,0,61,28,0,0,0,0,28,64,0,0,0,3,64,1337,51,30,0,10,1436
1005,145,13,0,0,0,150,65,6,0,0,0,75,58,3,3,0,0,62,132,14,3,0,0,147,193,19,5,3,0,216,679,41,11,3,0,738,824,41,4,0,0,871,937,21,0,0,0,964,375,5,0,0,0,377,201,0,0,0,0,205,96,3,0,0,0,100,129,5,7,0,0,136,3829,164,38,4,5,4042
1006,233,8,0,0,0,241,94,4,0,0,0,100,70,5,0,0,0,74,139,4,0,0,0,143,183,6,4,0,0,188,556,14,5,0,0,579,776,6,3,3,6,795,1084,23,0,3,3,1116,488,11,0,0,3,496,384,3,0,0,0,397,268,4,0,0,3,272,200,8,0,0,0,209,4469,93,26,10,19,4608
1007,141,6,0,0,0,146,160,0,0,0,0,166,151,0,0,0,0,157,288,3,0,0,0,298,296,3,0,3,0,305,477,0,0,0,0,485,237,3,0,0,0,240,138,0,0,0,0,136,38,0,0,0,0,45,27,0,0,0,0,27,27,0,0,0,0,27,107,0,0,0,0,107,2099,14,0,4,7,2130
1008,87,6,0,0,3,99,37,4,0,0,0,41,55,3,0,3,0,61,72,3,0,0,0,79,113,6,0,3,0,120,250,3,4,6,0,263,286,12,0,0,0,295,343,0,3,0,0,342,136,0,0,0,0,139,67,0,0,0,0,67,35,0,0,0,0,39,66,3,0,0,3,74,1543,40,11,9,3,1612
1009,1588,123,75,6,5,1799,695,71,37,4,0,812,567,84,41,4,3,702,1151,110,43,3,0,1310,1586,128,76,8,3,1802,4935,395,220,8,3,5557,6992,457,237,21,10,7724,9479,388,182,20,13,10074,4157,94,86,7,8,4350,2839,86,53,4,8,2993,1390,33,20,4,0,1452,1450,74,51,10,6,1586,36821,2046,1114,107,51,40144
1010,329,20,16,0,4,371,155,15,8,0,0,184,159,19,5,0,3,182,249,32,27,4,4,312,380,35,38,0,0,455,992,121,76,7,3,1202,1318,68,44,0,11,1439,1514,72,33,8,8,1627,556,22,3,0,0,585,329,21,7,0,4,360,162,3,5,0,3,178,231,20,12,0,0,261,6371,449,263,21,40,7153
1011,109,3,3,3,0,117,84,5,3,0,0,99,83,7,3,0,0,85,171,5,3,5,0,183,303,7,10,0,0,319,958,30,11,0,0,998,976,22,11,3,3,1010,830,4,0,6,3,846,259,3,0,5,0,266,151,0,0,0,0,155,65,0,0,0,0,67,159,9,7,0,0,175,4148,92,51,20,4,4323
1012,90,18,10,0,0,123,46,9,4,0,0,60,28,7,6,0,0,40,83,13,9,0,0,113,90,11,9,3,0,117,239,34,33,0,0,307,288,27,14,0,3,330,295,9,10,0,0,316,94,3,9,0,0,106,65,0,3,0,0,64,29,0,0,0,0,35,70,3,3,0,0,73,1428,149,104,3,13,1689
1013,95,5,0,0,0,101,57,10,0,0,0,63,64,3,0,0,0,70,106,8,3,0,0,112,181,4,3,0,0,194,508,23,4,0,0,533,614,23,0,3,0,636,496,8,3,0,0,504,150,0,0,0,0,151,87,0,0,0,0,89,52,0,0,0,0,52,94,3,0,0,0,99,2497,92,19,6,0,2610
1014,74,9,3,0,0,86,58,0,0,0,0,60,63,0,0,0,0,69,109,4,3,0,0,114,196,3,0,0,0,201,533,9,4,0,0,552,373,6,0,3,3,386,216,4,0,0,0,226,63,0,0,0,0,68,33,0,0,0,0,35,9,0,0,0,0,17,81,0,3,0,0,82,1821,39,20,3,9,1897
1015,66,3,0,0,0,68,30,0,0,0,0,30,34,0,3,0,0,40,59,0,3,0,0,62,110,4,7,0,0,124,387,18,12,0,0,416,409,8,13,0,0,427,323,4,3,0,0,331,94,3,0,0,0,92,60,0,0,0,3,57,35,0,0,0,0,38,66,0,3,0,0,72,1661,39,43,0,7,1746
1016,70,0,0,0,0,72,56,0,0,0,0,61,53,0,3,0,0,55,97,3,0,0,0,98,162,0,0,0,0,170,380,0,0,0,6,385,258,0,0,0,0,262,159,0,0,0,0,163,47,0,0,0,0,54,26,0,0,0,0,26,17,0,0,0,0,24,72,0,0,0,0,72,1407,11,4,0,10,1429
1017,153,3,7,0,0,162,80,8,9,0,0,105,77,6,3,0,0,89,194,15,5,0,0,218,216,18,3,0,0,235,635,53,13,0,0,709,746,40,3,0,0,791,508,12,3,0,0,522,144,0,0,0,0,147,75,0,0,0,0,75,36,3,0,0,0,39,106,3,0,0,0,110,2976,161,49,4,3,3201
1018,61,3,0,0,0,59,37,0,0,0,0,42,29,6,0,0,0,35,74,3,0,0,0,79,124,4,0,0,0,128,306,3,0,0,0,311,222,0,0,0,0,223,194,0,0,0,0,197,81,0,0,0,0,83,50,0,0,0,0,51,19,0,0,0,0,19,55,0,0,0,0,55,1250,27,3,0,4,1285
1019,147,0,0,0,3,149,65,0,0,0,0,69,58,0,0,0,0,56,93,0,0,3,0,95,139,4,0,0,0,140,391,8,0,3,0,405,528,7,0,0,0,539,653,0,3,0,0,658,256,0,0,0,0,262,176,0,0,0,0,181,91,0,0,0,0,96,128,0,0,0,0,130,2725,24,7,3,3,2760
1020,39,3,0,0,0,42,25,0,0,0,0,26,26,0,0,0,0,22,46,4,0,0,0,58,54,0,0,0,0,59,174,3,3,0,0,181,262,7,4,0,0,276,334,6,0,0,4,344,152,0,0,0,0,157,85,0,0,0,0,87,43,0,0,0,3,46,50,0,0,0,0,51,1304,24,13,3,7,1353
1021,32,0,0,0,0,33,25,0,0,0,0,27,15,0,0,0,0,15,51,0,0,0,0,51,67,3,3,0,0,73,266,3,3,0,0,268,302,9,0,0,0,304,301,7,0,0,0,300,105,4,0,0,0,109,76,0,0,0,0,79,23,0,0,0,0,26,68,0,0,0,0,68,1324,27,6,0,0,1358
1022,123,25,5,3,3,157,55,9,3,0,0,65,43,22,0,0,0,59,69,13,3,0,0,87,96,26,3,0,0,132,237,68,17,0,3,328,334,84,13,0,0,431,557,67,8,0,3,644,258,30,3,0,0,284,153,13,0,0,0,169,84,11,4,0,0,101,98,16,0,0,0,114,2103,377,61,15,12,2572
1023,2280,168,73,7,3,2523,1178,89,25,3,0,1291,1033,70,24,0,0,1121,1853,101,45,0,9,2012,2716,167,50,3,0,2941,8210,552,194,15,15,8984,10588,582,238,20,16,11447,13551,545,214,12,16,14350,5761,190,85,5,10,6049,3826,133,61,8,5,4033,1925,89,57,3,6,2081,2026,87,42,3,6,2171,54942,2776,1115,80,90,59002
1024,179,4,0,3,0,184,89,5,0,0,0,95,90,3,0,0,0,99,181,6,8,0,0,195,228,9,5,0,0,240,724,25,10,3,3,765,787,29,11,0,0,827,770,4,0,0,0,776,264,0,3,0,0,268,166,0,0,0,0,172,76,0,0,0,0,76,154,0,0,0,0,159,3719,88,34,6,10,3855
1025,144,3,0,0,0,146,84,0,0,0,0,88,75,0,0,0,0,75,197,3,3,0,0,206,272,14,4,0,0,292,796,31,12,0,3,837,982,27,7,0,3,1013,994,5,0,0,4,1005,372,3,0,0,0,382,245,0,0,0,0,249,107,0,0,0,0,113,147,7,0,0,3,159,4413,97,31,3,13,4554
1026,43,0,0,0,0,43,31,0,0,0,0,29,31,0,0,0,0,33,77,0,0,0,0,77,104,0,0,0,0,111,341,3,0,0,0,342,234,0,0,0,0,239,168,0,0,0,0,168,71,0,0,0,0,67,33,0,0,0,0,33,24,0,0,0,0,24,51,0,0,0,0,51,1203,7,5,0,3,1224
1027,185,23,14,0,0,226,78,24,20,0,0,119,64,17,6,0,0,81,102,19,20,4,0,139,193,31,26,0,0,247,511,86,53,6,0,663,767,116,63,3,3,949,1067,62,32,0,0,1159,398,17,9,0,0,422,245,13,6,0,0,269,120,12,11,0,0,139,148,24,9,0,0,187,3864,446,259,11,18,4599
1028,73,0,0,0,0,74,19,0,0,0,0,21,28,0,0,0,0,24,44,0,0,0,0,50,65,3,3,0,0,76,270,27,8,0,0,301,357,24,11,0,0,392,525,17,4,0,0,549,261,3,0,0,0,266,149,0,0,0,0,156,55,0,0,0,0,55,75,3,0,0,0,76,1929,82,23,0,5,2046
1029,132,3,0,0,0,139,77,0,0,0,0,77,48,0,0,0,0,52,91,0,0,0,0,94,154,0,3,0,0,156,365,8,9,0,0,377,383,5,0,0,0,389,324,3,0,0,0,331,112,3,0,0,0,114,66,3,0,0,0,72,35,3,0,0,0,39,75,0,0,0,0,78,1865,31,13,0,3,1910
1030,17153,3298,4569,68,68,25156,5016,947,1168,19,8,7153,4343,806,1066,16,8,6240,6634,1323,1913,23,12,9907,9437,1919,2901,47,21,14328,28773,5870,9523,104,82,44353,34297,7627,12480,120,90,54616,64414,13382,20564,203,189,98754,43395,8965,12317,130,125,64930,52479,10982,11961,141,171,75727,49834,10892,7531,123,192,68572,15935,2733,2854,61,50,21629,331697,68744,88850,1058,1023,491363
1031,157,7,0,3,0,168,73,4,0,3,0,81,86,6,0,0,0,94,194,8,3,6,0,203,300,13,3,10,3,328,1007,20,3,12,4,1044,1008,21,0,3,0,1034,816,7,3,0,4,829,241,0,0,0,0,245,117,0,0,0,0,119,57,0,0,0,0,63,166,3,0,0,0,174,4216,91,10,41,17,4381
1032,130,4,0,0,0,137,101,0,3,0,0,107,90,3,0,0,0,90,182,0,3,0,0,184,247,12,6,6,3,272,699,15,5,0,5,720,477,6,4,0,0,486,297,3,0,0,3,301,88,0,0,0,0,90,60,0,0,0,0,58,31,0,0,0,0,27,113,0,0,0,0,118,2503,50,25,7,10,2594
1033,98,0,0,0,0,105,43,0,0,0,0,43,36,3,0,3,0,44,78,4,0,0,0,84,110,5,0,0,0,119,240,7,4,0,4,253,278,8,4,0,0,291,253,0,0,0,0,255,89,3,0,0,0,91,50,0,0,0,0,50,34,0,0,3,0,43,73,3,0,0,0,71,1382,32,9,9,11,1441
1034,226,8,7,3,0,246,123,0,3,0,0,126,109,0,3,0,0,114,214,0,22,0,0,235,408,3,11,3,0,433,1318,22,40,4,0,1389,1495,18,20,4,6,1548,1238,4,5,11,0,1264,408,0,3,3,0,411,292,3,4,0,0,296,138,0,3,0,4,145,229,8,5,3,0,247,6201,76,126,32,16,6449
1035,1193,107,86,3,6,1391,589,52,48,0,0,687,433,45,30,3,0,508,841,125,66,4,5,1040,1149,131,117,3,6,1403,3343,388,320,4,6,4052,4419,500,394,17,9,5340,7124,625,427,19,26,8226,3788,255,149,3,11,4204,3157,148,119,0,9,3439,1481,70,63,3,9,1618,1052,79,58,6,4,1208,28567,2527,1869,67,84,33109
2000,5295,38,22,36,52,5441,3567,18,20,30,17,3653,3246,33,25,20,20,3347,6254,51,39,37,23,6408,7908,44,52,46,51,8100,17848,99,69,89,87,18191,14157,69,36,39,72,14366,12132,61,21,60,68,12348,4269,11,7,22,22,4328,3200,13,8,19,31,3273,2122,14,3,18,24,2182,4832,19,15,36,45,4944,84823,467,320,449,510,86573
2001,110,5,0,0,0,114,56,6,0,0,0,65,54,4,0,0,0,58,105,3,0,0,0,104,179,10,0,0,0,196,579,34,0,0,0,613,717,25,0,0,0,742,652,34,0,0,0,690,204,23,0,0,0,220,149,8,0,0,0,151,36,0,0,0,0,36,137,4,0,0,0,142,2972,157,4,3,5,3140
2002,70,0,3,0,0,73,60,0,0,0,0,60,55,3,0,0,0,57,91,0,0,0,0,90,171,0,0,0,0,170,424,0,0,0,0,426,364,0,0,0,0,367,190,0,0,0,0,196,51,0,0,0,0,51,40,0,0,0,0,40,17,0,0,0,0,17,67,0,0,0,0,71,1602,15,3,3,4,1626
2003,477,34,4,0,0,515,340,30,0,0,0,372,323,29,5,0,0,360,603,64,9,8,3,685,1019,91,3,3,0,1113,2852,246,21,5,11,3137,2444,171,15,3,5,2642,1840,89,4,10,6,1952,566,23,0,3,0,592,378,23,0,3,0,408,222,7,0,0,0,237,418,25,0,0,0,445,11489,828,74,36,37,12456
2004,536,15,5,0,3,560,374,10,3,0,0,391,328,12,3,0,0,343,656,25,4,0,0,685,928,37,3,3,3,971,2787,86,18,0,5,2898,2695,50,15,3,3,2765,1910,31,8,4,7,1953,518,3,0,0,3,525,339,8,0,0,0,350,183,6,0,0,0,187,476,3,0,3,0,481,11731,284,58,16,28,12117
2005,54,3,0,0,3,61,45,0,0,0,0,47,51,4,0,0,0,53,103,3,0,0,0,105,155,3,0,0,0,160,431,8,0,3,0,438,301,0,0,0,0,303,151,3,0,0,0,152,35,0,0,0,0,35,27,0,0,0,0,27,16,0,0,0,0,16,73,0,0,0,0,73,1444,28,0,3,3,1478
2006,99,3,0,0,0,107,52,3,0,0,0,50,56,0,0,0,0,52,117,3,3,0,0,119,165,12,3,0,0,182,559,23,0,0,3,582,513,13,0,0,0,527,412,4,0,0,0,412,115,0,0,0,0,113,83,0,0,0,0,87,43,0,0,3,0,46,114,0,0,0,0,112,2316,67,11,3,4,2404
2007,1426,82,12,0,0,1522,788,56,10,0,3,860,694,55,6,0,3,758,1340,91,23,4,0,1457,1837,151,39,3,0,2033,5337,364,90,14,12,5817,6004,310,44,13,12,6387,6234,240,36,22,13,6554,2252,85,13,5,4,2358,1649,46,9,4,4,1719,866,34,3,3,4,907,1294,72,15,10,0,1393,29727,1595,302,82,61,31761
2008,139,4,0,0,0,147,53,0,0,0,0,59,54,3,0,0,0,53,90,9,0,0,0,96,118,4,0,0,0,125,356,20,0,0,0,380,479,25,0,0,4,506,742,10,0,0,0,755,400,10,0,0,0,410,336,3,0,0,0,342,211,0,0,0,0,211,165,3,0,0,0,168,3148,86,0,0,3,3241
2009,99,3,0,0,0,99,66,0,0,0,0,63,69,4,0,0,0,74,192,0,3,0,0,201,246,6,7,0,0,260,608,10,7,0,0,624,400,3,0,0,0,401,221,0,0,0,0,222,67,0,0,0,0,67,42,0,0,0,0,42,27,0,0,0,3,27,72,0,3,0,0,74,2100,31,23,0,0,2159
2010,22637,3990,1992,60,66,28744,8748,1432,616,18,12,10822,7703,1234,604,16,18,9570,12723,2057,1051,20,17,15865,18088,3023,1555,34,31,22737,55854,9848,5725,118,107,71643,70167,12430,7194,127,147,90066,97326,15834,9365,184,211,122917,44255,8151,4247,82,122,56860,38982,8117,3334,60,104,50602,29719,6390,2092,45,100,38343,20404,2880,1238,44,49,24612,426609,75379,39007,817,978,542784
2011,293,34,0,0,0,325,183,20,0,0,0,202,169,14,0,0,0,185,314,35,0,0,0,345,505,48,3,0,0,562,1945,212,5,0,3,2156,2160,174,3,0,4,2340,1690,92,4,0,7,1786,399,19,0,0,0,412,229,12,0,3,0,242,141,6,0,0,0,147,380,23,0,0,0,406,8399,685,18,4,14,9116
2012,234,10,9,0,0,251,174,6,3,0,0,186,173,6,0,0,0,176,442,20,10,0,3,473,685,24,16,4,3,736,1613,61,13,0,5,1691,1078,18,5,0,0,1108,690,3,0,0,3,694,194,0,0,0,0,198,128,0,0,0,0,128,83,0,0,0,0,88,270,10,4,0,0,284,5763,160,60,6,24,6012
2013,76,3,4,0,0,84,108,3,0,0,0,119,105,6,3,0,0,108,229,5,0,0,0,237,261,3,3,0,0,267,526,14,0,0,0,546,261,4,0,0,0,261,183,0,0,0,0,189,44,0,0,0,0,44,25,0,0,0,0,25,24,0,0,0,0,24,92,4,3,0,0,98,1931,51,12,4,0,1997
2014,74,3,3,0,0,78,46,0,0,0,0,47,62,0,0,0,0,65,101,0,0,0,0,104,128,0,0,0,0,128,358,5,0,0,0,363,226,4,3,0,0,228,132,0,0,0,0,137,37,0,0,0,0,38,34,0,0,0,0,34,15,0,0,0,0,12,68,0,0,0,0,68,1288,10,13,0,5,1313
2015,75,4,5,0,0,84,61,4,0,0,0,65,55,3,4,0,0,63,94,3,0,0,0,103,172,7,3,0,0,184,396,12,3,0,0,417,353,3,7,0,0,359,224,0,0,0,0,228,97,0,0,0,0,97,51,0,0,0,0,53,20,0,0,0,0,20,60,0,0,0,0,63,1654,37,21,9,5,1727
2016,233,11,0,0,0,241,135,9,0,0,0,145,147,6,0,0,0,155,354,17,0,0,0,372,545,28,0,3,0,578,1445,37,0,0,0,1489,1178,21,0,0,0,1202,793,17,0,0,0,810,218,0,0,0,0,215,131,4,0,0,0,134,82,0,0,0,0,82,245,10,0,4,0,257,5502,158,4,9,7,5686
2017,35,3,0,0,0,38,31,0,0,0,0,32,27,0,0,0,0,33,99,3,0,0,0,105,141,5,7,0,0,151,285,8,3,0,3,305,212,5,3,0,3,223,157,0,0,0,3,164,32,0,0,0,0,34,26,0,0,0,0,26,18,0,0,0,0,21,50,4,0,0,3,58,1123,23,18,0,15,1177
2018,207,3,13,0,0,219,165,4,3,0,0,176,186,6,10,0,0,205,442,6,15,0,3,458,604,10,14,0,0,628,1259,27,15,0,3,1307,906,11,12,0,0,927,744,10,0,0,0,751,193,0,0,0,0,193,110,4,0,0,0,117,69,0,0,0,0,69,189,3,0,0,0,193,5074,81,81,3,8,5247
2019,102,3,0,0,0,107,81,0,0,0,0,79,64,0,0,0,0,64,130,13,0,0,0,143,239,16,0,0,0,254,620,25,3,0,0,640,457,8,0,0,0,467,290,0,0,0,0,294,78,0,0,0,0,78,45,3,0,0,0,50,17,0,0,0,0,22,84,3,0,0,0,92,2206,74,7,3,4,2286
2020,237,8,3,0,0,244,115,4,3,0,0,118,93,3,0,0,0,99,192,3,0,0,0,196,296,8,6,0,0,308,1023,20,6,0,0,1051,1014,3,3,0,0,1022,844,0,0,4,3,850,270,0,0,0,0,279,193,0,0,0,0,193,110,0,0,0,0,107,208,5,3,0,0,214,4587,51,29,12,12,4686
2021,176,13,7,0,0,191,111,10,0,0,0,116,82,3,0,0,0,83,171,17,3,0,0,196,269,12,7,3,0,294,853,60,17,6,0,932,874,24,3,4,3,912,694,19,3,3,0,712,186,12,0,0,0,201,106,4,0,0,0,114,73,3,0,0,0,74,145,12,3,0,0,163,3739,181,37,18,9,3993
3000,4629,40,35,68,50,4821,2416,12,18,30,18,2495,2262,15,11,33,17,2340,4267,42,38,74,35,4458,5685,53,51,63,24,5878,13946,130,81,106,72,14334,13230,96,57,102,76,13568,13876,92,47,87,78,14180,5942,21,19,37,28,6049,4090,28,7,27,37,4194,2172,20,10,45,34,2280,4200,19,30,64,32,4343,76720,558,404,734,512,78932
3001,11145,574,646,16,25,12409,4520,305,224,9,5,5066,3903,281,238,19,3,4443,6852,530,421,12,5,7828,9520,734,646,15,14,10938,29944,2545,2161,35,64,34746,40678,3231,3017,64,78,47071,59720,3078,3567,57,101,66520,30193,979,1390,28,55,32644,23648,653,1006,33,44,25382,13854,333,637,24,33,14879,9589,394,413,23,31,10453,243565,13650,14373,331,456,272375
3002,347,7,11,0,3,369,239,10,4,0,0,253,196,4,0,0,0,202,401,7,13,0,0,422,533,22,10,3,0,564,1648,36,30,0,5,1716,1581,18,31,0,3,1627,1133,7,18,0,0,1164,344,3,4,0,0,348,211,0,3,0,0,218,113,3,0,0,0,118,287,5,9,0,0,298,7021,121,133,7,14,7296
3003,609,28,50,0,3,694,280,19,43,0,0,337,266,25,35,0,0,321,532,67,91,3,6,698,722,99,178,4,7,1000,2373,248,282,4,5,2909,3237,119,237,3,12,3605,3860,76,134,0,6,4081,1356,6,48,0,3,1408,892,13,31,4,3,948,471,9,21,0,3,505,564,28,39,3,0,638,15153,732,1195,23,42,17145
3004,21,0,0,0,0,21,12,3,0,0,0,12,18,0,0,0,0,20,35,0,0,0,0,44,57,0,0,0,3,60,178,5,7,0,0,189,243,15,11,0,0,262,451,14,5,0,0,467,229,0,3,0,0,239,154,0,0,0,0,158,55,0,0,0,0,60,51,0,3,0,0,54,1503,43,28,5,8,1592
3005,172,0,0,0,0,174,71,3,9,0,0,86,71,0,0,0,0,69,117,7,4,0,0,122,217,4,5,0,0,230,620,21,16,0,0,661,949,14,17,4,0,987,1462,24,8,3,0,1500,819,8,9,3,3,838,531,0,7,0,0,543,223,0,0,0,0,227,198,3,0,0,0,196,5447,95,81,5,6,5629
3006,2483,551,357,9,0,3397,981,269,139,0,3,1390,749,251,125,0,3,1130,1412,470,271,15,8,2184,1991,657,381,9,11,3050,5945,2180,1252,15,16,9409,7900,2751,1305,14,29,11997,14951,2110,1210,24,31,18328,8279,632,381,9,22,9322,5873,394,324,13,9,6615,3339,206,215,0,16,3782,2586,436,287,4,7,3321,56491,10917,6258,119,160,73938
3007,101,3,0,3,0,107,99,3,0,0,0,104,59,0,0,0,0,59,130,0,0,0,0,128,209,5,0,0,0,218,552,6,3,3,0,558,479,3,0,0,0,482,305,4,0,0,0,310,75,3,0,3,0,82,42,0,0,0,0,42,22,0,0,0,0,26,66,0,0,0,0,71,2137,24,7,11,8,2181
3008,250,13,7,0,3,270,138,16,0,0,0,161,136,9,0,0,0,142,241,11,3,0,0,259,283,19,3,3,0,309,866,53,12,4,11,950,1091,32,5,0,0,1136,869,19,4,4,3,894,281,0,3,0,0,279,167,0,3,0,0,164,78,0,0,0,0,81,171,11,3,3,0,184,4566,185,45,24,23,4841
3009,35,0,0,0,0,40,28,3,0,0,0,31,28,0,0,0,0,30,59,4,0,0,0,61,101,3,0,0,0,108,251,3,3,0,0,256,216,0,0,0,3,219,158,0,0,0,0,160,39,0,0,0,0,39,18,0,0,0,0,17,14,0,0,0,0,14,42,0,0,0,0,42,980,16,6,4,4,1011
3010,353,9,5,0,0,372,124,8,0,0,0,135,114,11,4,3,0,125,229,16,4,0,0,260,372,29,16,0,0,419,1111,78,26,3,0,1223,1527,100,21,0,3,1648,2501,60,32,0,4,2592,1352,23,17,0,4,1398,844,15,9,3,0,871,345,4,10,3,0,363,359,11,3,0,0,373,9230,361,144,11,21,9772
3011,131,0,0,0,0,130,99,3,0,0,0,102,118,0,0,0,0,126,206,3,0,0,0,205,285,3,0,0,0,295,784,4,4,0,0,789,503,4,0,0,3,507,316,0,0,0,0,315,88,0,0,0,0,88,55,0,0,0,0,57,29,0,0,0,0,27,123,3,0,0,0,122,2727,19,12,3,8,2773
3012,53,3,0,0,0,55,21,0,0,0,0,20,28,3,0,0,0,26,37,0,0,0,0,35,86,3,0,0,0,89,212,9,0,12,6,235,375,11,5,3,0,395,614,7,3,4,0,630,223,4,0,0,0,226,121,4,0,0,0,122,77,0,0,0,0,81,77,0,0,0,0,84,1910,51,16,22,8,2011
3013,337,6,0,0,0,347,194,3,3,0,0,200,157,6,0,0,0,158,343,10,0,0,0,352,570,15,9,0,0,595,1844,32,14,0,3,1896,2082,22,23,3,0,2128,1957,22,18,5,3,2006,644,3,0,3,0,651,428,0,5,0,0,437,189,0,0,0,3,195,340,6,7,0,3,357,9082,124,80,18,16,9314
3014,1594,150,118,0,3,1869,720,103,59,0,3,885,573,66,55,0,3,698,1016,97,88,18,0,1213,1487,148,126,5,13,1773,4182,493,360,7,18,5068,5253,505,371,7,12,6151,8371,352,326,6,25,9083,3953,103,117,6,15,4198,2750,64,95,3,9,2921,1385,32,52,3,12,1486,1418,100,54,8,11,1587,32704,2215,1814,68,131,36930
3015,607,21,13,0,3,649,350,23,11,3,0,388,286,20,9,0,0,318,603,33,16,4,0,658,819,65,23,0,0,904,2757,181,56,9,10,3010,3424,148,28,7,14,3625,3148,79,22,7,6,3262,1207,15,6,3,0,1224,726,14,4,3,3,747,353,4,3,0,3,364,449,21,3,3,0,477,14728,624,196,39,36,15630
3016,712,32,21,0,0,771,325,15,13,0,0,358,300,13,9,0,0,323,660,43,33,0,0,734,910,65,28,4,0,1010,3135,196,119,6,4,3458,4384,136,96,3,3,4628,5084,60,88,6,12,5250,1924,19,28,5,0,1980,1231,12,33,3,7,1281,574,11,29,3,0,613,682,26,14,0,3,720,19922,626,506,33,33,21121
3017,66,0,0,0,0,71,55,3,0,0,0,57,39,0,0,0,0,42,89,0,0,0,0,93,140,4,0,0,0,142,425,13,0,0,0,440,322,0,0,0,0,321,228,0,0,0,0,236,61,0,0,0,0,64,39,0,0,0,0,37,19,0,0,0,3,18,64,0,0,0,0,60,1543,33,4,4,7,1583
3018,79,3,3,0,0,80,29,3,3,0,0,37,36,3,0,0,0,39,58,0,4,0,0,61,78,0,0,0,0,81,261,7,16,0,3,290,377,9,11,0,0,394,568,7,10,0,0,586,287,0,6,0,0,297,175,3,3,0,0,180,67,0,3,0,0,70,69,4,4,0,0,72,2078,42,60,3,8,2194
4000,2306,23,10,15,18,2376,1680,17,3,16,8,1722,1540,21,5,10,14,1589,2877,39,6,21,18,2960,3521,34,3,13,16,3583,6953,51,9,35,31,7075,5111,24,5,20,16,5184,3830,10,6,21,22,3895,1253,3,3,5,13,1274,957,3,0,14,4,978,596,4,0,14,0,622,1386,6,3,9,10,1415,32011,225,52,203,170,32656
4001,7697,1005,251,13,21,8992,4489,555,169,8,7,5229,3993,524,162,4,5,4692,7319,1002,323,7,10,8661,9675,1311,504,15,19,11517,27703,3555,1510,36,76,32886,30233,3582,1119,28,89,35044,30359,3609,643,15,108,34736,11646,1300,194,16,40,13189,8746,935,125,12,34,9844,5326,569,93,8,20,6029,5047,510,143,4,14,5724,152244,18452,5236,174,441,176549
4002,144,20,0,0,0,170,96,18,9,0,0,122,113,16,6,0,0,140,288,36,17,0,0,339,461,29,19,0,0,516,1100,39,7,3,0,1152,676,10,6,0,4,691,369,9,0,0,0,385,111,0,3,0,0,118,59,0,0,0,0,66,34,0,0,0,0,34,123,6,0,0,0,129,3583,190,61,11,7,3857
4003,96,3,0,0,0,103,81,7,0,0,0,87,65,3,0,0,0,67,151,13,0,0,3,169,208,12,0,0,0,228,572,10,0,0,4,584,342,8,0,0,6,348,170,0,0,0,0,176,45,0,0,0,0,44,21,0,0,0,0,21,17,0,0,0,0,17,60,0,0,0,0,63,1834,57,3,3,15,1913
4004,64,3,0,0,0,67,46,3,0,0,0,50,47,3,4,0,0,57,128,8,3,0,0,137,169,6,0,0,0,180,329,17,0,0,4,350,252,5,0,0,0,259,160,4,0,0,0,165,50,0,0,0,0,54,38,0,0,0,0,36,6,4,0,0,0,9,46,3,0,0,0,54,1331,66,7,3,9,1415
4005,76,6,0,0,3,80,51,3,0,0,0,63,59,3,3,0,0,69,109,9,0,3,3,127,162,15,3,3,0,184,455,28,3,3,3,490,410,17,0,0,0,423,290,10,0,3,0,308,85,3,0,0,0,92,63,3,0,0,0,61,28,0,0,0,0,26,68,3,0,0,0,69,1864,102,14,11,14,2001
4006,87,13,0,0,0,101,106,9,0,0,0,114,105,11,0,0,0,117,219,15,0,0,0,232,225,9,0,0,0,236,444,5,0,0,3,454,211,4,0,0,0,218,124,4,0,0,0,127,39,0,0,0,0,41,22,0,0,0,0,23,11,0,0,0,0,11,68,4,0,0,0,74,1666,69,0,0,8,1740
4007,209,5,0,0,0,223,141,3,0,0,0,148,122,4,0,0,0,124,179,7,8,0,0,189,243,10,3,0,3,257,586,15,3,0,0,606,486,4,0,0,3,495,304,5,3,0,6,317,91,0,0,0,0,93,62,0,0,0,0,62,47,0,0,0,0,47,92,4,0,0,0,93,2566,60,13,3,12,2652
4008,74,39,4,0,0,112,48,68,0,0,0,120,60,61,0,0,0,122,111,149,0,0,0,269,160,159,0,0,0,323,466,222,4,3,4,707,424,50,0,3,0,481,380,27,0,0,0,411,104,6,0,0,0,107,73,9,0,0,0,83,22,5,0,0,0,24,84,29,3,0,0,117,2016,836,17,9,12,2884
5000,1781,3,3,22,25,1836,957,3,4,13,11,986,831,8,3,11,4,859,1490,14,0,10,3,1526,1734,11,6,13,17,1785,4229,43,9,32,14,4326,3887,13,9,33,21,3967,4682,14,9,45,35,4786,2179,13,6,24,16,2238,2090,3,3,21,18,2135,1178,10,6,16,12,1221,1354,12,0,21,13,1393,26391,143,55,260,191,27050
5001,179,4,0,0,0,184,119,3,0,0,0,127,79,9,0,3,0,91,153,4,0,0,0,157,203,0,0,0,0,210,673,12,0,0,3,692,750,6,0,0,3,761,878,14,0,0,3,897,302,3,0,0,0,311,179,3,0,0,0,185,92,0,0,0,0,92,156,0,0,0,0,159,3775,58,3,6,17,3855
5002,38,0,0,0,0,38,5,0,0,0,0,8,13,0,0,0,0,11,17,0,3,0,0,22,21,0,3,3,0,28,78,5,0,3,0,85,93,5,3,0,0,101,173,9,15,4,0,194,197,3,10,4,0,208,249,8,0,6,3,255,142,0,0,4,3,143,63,0,0,0,0,72,1080,34,31,19,8,1180
5003,386,26,6,0,3,423,187,10,0,0,0,200,161,11,0,0,0,171,322,15,3,3,0,340,453,28,3,3,0,483,1386,105,6,0,4,1503,1996,83,9,0,5,2099,2805,52,9,5,3,2869,1072,20,3,0,0,1094,635,23,4,0,3,669,285,8,0,0,0,294,352,12,6,0,0,372,10033,393,48,18,14,10506
5004,247,3,0,0,0,255,70,4,0,0,0,81,72,8,0,0,0,84,140,6,0,0,3,152,181,7,0,0,0,188,557,18,0,0,0,577,705,22,0,4,0,728,1144,37,3,4,0,1183,518,10,0,3,4,534,382,3,0,3,3,390,176,5,0,3,0,184,184,6,0,0,0,192,4382,122,3,21,15,4546
5005,53,0,0,0,0,57,27,0,0,0,0,33,30,0,0,0,0,30,46,0,0,0,0,44,92,0,0,0,0,90,215,3,3,0,0,224,211,3,3,0,4,221,299,3,0,3,0,310,129,0,0,0,0,133,102,0,0,0,0,103,39,0,0,0,0,41,67,0,0,0,0,67,1316,16,7,6,9,1355
5006,157,14,0,0,0,171,111,3,0,0,0,113,95,3,0,3,0,102,176,6,0,4,0,187,250,20,0,8,0,274,686,30,0,7,4,731,811,31,3,3,0,852,1003,29,0,6,0,1035,541,11,0,4,0,557,335,10,3,3,0,352,148,12,0,4,0,166,149,5,4,0,0,161,4468,171,11,46,7,4700
5007,81,6,0,0,0,87,33,0,0,0,0,34,50,3,0,0,0,54,109,8,0,0,0,122,164,21,0,0,0,184,614,61,3,0,0,675,721,61,3,0,0,786,1066,52,4,0,0,1122,445,20,0,0,0,467,313,6,0,0,0,322,133,0,0,0,0,140,149,11,0,0,0,164,3877,247,15,7,5,4151
5008,16,3,0,0,0,22,5,0,0,0,0,5,5,0,0,0,0,5,7,0,0,0,0,11,8,7,0,0,0,14,39,6,0,0,0,45,70,7,0,0,0,74,141,7,0,0,0,146,83,5,0,0,0,91,138,5,0,0,0,146,128,6,0,0,0,134,23,3,0,0,0,22,666,52,8,3,3,728
5009,11135,1422,365,15,20,12955,4195,580,137,9,12,4922,3755,456,119,4,10,4339,6578,866,255,15,6,7718,8559,1140,327,13,14,10055,25674,3706,1254,32,41,30704,33637,5397,1650,46,60,40789,60262,7801,1973,54,100,70177,35274,3576,868,23,74,39814,27655,2855,689,32,69,31290,18136,1726,459,29,51,20396,8983,957,242,10,14,10205,243848,30466,8343,257,455,283365
5010,8,0,3,0,0,16,3,0,0,0,0,3,3,0,0,0,0,3,3,0,0,0,0,4,8,0,3,0,0,13,27,3,0,0,0,37,30,3,0,0,0,41,55,0,5,0,0,65,36,0,0,0,0,37,93,3,0,0,0,97,73,0,0,0,0,77,18,0,0,0,0,22,369,17,13,3,0,404
5011,78,0,0,0,0,78,32,0,0,0,0,29,21,0,0,0,0,24,45,0,0,0,0,49,48,0,0,0,0,54,160,5,0,0,0,164,304,6,0,0,0,317,692,19,0,0,8,716,376,3,0,0,0,378,186,4,0,0,0,187,86,0,0,0,0,84,91,0,0,0,0,89,2109,47,3,7,5,2170
6000,1292,3,0,9,10,1312,1048,0,4,9,7,1069,981,3,3,8,3,999,1725,5,9,13,10,1762,2158,14,3,10,12,2198,4554,10,14,11,11,4608,3320,10,6,12,14,3365,2151,4,3,17,11,2184,646,4,0,3,4,656,426,0,0,3,0,429,278,0,0,3,7,288,845,4,3,11,6,869,19417,68,45,114,100,19746
6001,174,3,0,0,0,176,132,0,0,0,0,139,167,3,0,0,0,174,280,3,3,0,0,284,443,6,0,0,0,453,970,3,0,0,0,974,539,3,0,0,0,546,294,3,0,0,0,294,87,0,0,0,0,91,47,0,0,0,0,50,28,0,0,0,0,30,111,0,0,0,0,112,3275,29,10,3,4,3315
6002,155,5,0,0,0,160,150,3,0,0,0,160,140,3,3,0,0,148,243,10,0,0,0,253,401,15,3,0,0,417,1038,13,0,0,0,1047,665,4,0,0,0,668,360,3,0,0,0,365,87,0,0,0,0,87,58,0,0,0,0,63,27,0,0,0,0,27,107,3,0,0,0,109,3432,49,8,8,8,3502
6003,1371,43,56,7,0,1475,846,25,28,0,0,906,720,29,31,0,0,781,1422,62,52,4,7,1547,1939,81,117,4,3,2144,5398,163,207,13,17,5792,5398,135,145,9,7,5691,4501,82,75,8,6,4675,1504,38,26,0,0,1566,1104,31,15,3,0,1151,602,20,14,4,4,639,797,22,31,6,0,853,25592,719,791,54,48,27207
6004,438,22,20,0,0,479,340,19,13,0,0,372,298,13,9,0,0,315,686,30,20,0,0,732,1037,43,44,0,3,1127,2687,96,66,5,8,2857,2090,66,24,3,7,2190,1318,46,15,4,6,1382,379,17,8,0,0,404,283,13,6,3,0,309,150,4,0,0,0,153,330,10,4,0,0,345,10037,367,226,22,28,10678
6005,102,4,0,0,0,108,70,0,0,0,0,72,66,3,0,0,0,67,147,3,0,0,0,159,188,8,0,0,0,196,467,5,3,7,0,481,311,8,0,0,0,319,196,0,0,0,0,197,53,0,0,0,0,53,46,0,0,0,0,46,15,0,0,0,0,15,56,0,0,0,0,56,1717,32,3,6,6,1768
7000,100,0,0,9,0,105,60,0,0,0,0,61,62,0,0,3,0,64,107,0,7,0,3,114,129,0,3,6,0,130,391,4,0,16,4,410,460,3,4,16,6,485,587,3,5,14,7,616,417,0,0,10,9,437,536,0,0,5,7,555,267,3,0,7,4,272,170,0,0,7,5,185,3269,12,28,84,44,3445
7001,46,11,0,0,0,59,26,3,0,0,0,30,16,12,0,0,0,32,41,18,0,7,0,69,86,31,0,8,0,122,233,100,14,15,0,358,358,134,12,11,0,521,594,132,3,26,3,758,348,35,3,18,0,402,248,17,0,9,0,279,113,11,0,3,0,129,86,7,0,10,0,103,2199,504,30,106,7,2855
7002,283,37,66,0,3,392,127,13,21,0,0,166,99,11,20,0,0,136,185,20,45,7,3,254,268,37,80,4,0,386,875,136,232,12,0,1259,1053,182,303,5,0,1548,1979,266,499,19,0,2760,1799,142,259,7,6,2220,1849,88,190,7,3,2139,1013,38,94,6,3,1161,435,44,58,0,3,537,9971,1021,1872,61,32,12948
8000,3,0,0,0,0,3,3,0,0,0,0,3,0,0,0,0,0,0,3,0,0,0,0,3,3,0,0,0,0,3,8,0,0,0,0,7,12,0,0,0,0,12,29,0,0,0,0,29,17,0,0,0,0,17,25,0,0,0,0,25,12,0,0,0,0,12,7,0,0,0,0,7,124,0,0,0,0,129
8001,2087,330,147,0,3,2573,801,115,54,0,0,970,663,102,68,0,0,834,1084,242,121,3,0,1462,1490,325,210,0,0,2027,4185,983,743,3,3,5918,5516,1815,1242,0,10,8587,11528,2499,1234,5,7,15272,7403,880,407,4,9,8707,6505,676,307,0,3,7494,3623,297,174,0,0,4097,1470,214,110,0,3,1803,46356,8487,4813,31,44,59734
9000,18,0,0,0,0,17,9,0,0,0,0,9,9,0,0,0,0,9,13,0,0,0,0,12,20,0,0,0,0,25,59,0,3,0,0,65,54,0,3,0,0,57,42,3,0,0,0,46,19,0,0,0,0,19,14,0,0,0,0,11,11,0,0,0,0,9,13,0,0,0,0,13,279,11,11,0,3,299