SUA_CODE_2016,All_inc_NS_Emp_AW,All_inc_NS_E_T,All_inc_NS_UnE_lfw_FTW,All_inc_NS_UnE_lfw_PTW,All_inc_NS_UnE_lfw_Tot,All_inc_NS_T_LF,All_inc_NS_Notin_LF,All_inc_NS_LF_sta_NS,All_inc_NS_Tot,Tot_Emp_WFT,Tot_Emp_WPT,Tot_Emp_AW,Tot_E_T,Tot_UnE_lfw_FTW,Tot_UnE_lfw_PTW,Tot_UnE_lfw_Tot,Tot_T_LF,Tot_Notin_LF,Tot_LF_sta_NS,Tot_Tot
1000,57,263,38,31,69,332,575,305,1216,9169,9192,1077,19445,1295,1132,2426,21873,17206,615,39694
1001,6,28,4,0,4,37,41,25,91,1129,1013,126,2266,153,135,288,2556,1568,42,4163
1002,3,8,3,0,4,10,14,7,33,286,228,18,532,29,26,57,585,389,15,993
1003,3,11,0,0,0,12,17,9,39,303,352,30,682,20,27,46,728,449,8,1190
1004,4,7,0,0,0,13,15,4,32,155,194,34,378,21,19,48,424,351,6,775
1005,0,6,0,0,0,5,21,10,40,489,378,40,909,42,48,90,1001,630,20,1650
1006,3,13,0,0,0,11,15,3,29,417,390,42,848,19,27,51,897,590,8,1495
1007,0,8,3,0,3,12,19,15,50,222,228,39,487,49,31,80,569,468,24,1059
1008,0,8,0,0,0,8,9,3,15,140,190,18,351,21,16,36,386,280,12,679
1009,25,92,3,16,17,110,141,97,347,4464,3938,438,8833,466,476,949,9781,6696,180,16651
1010,3,20,3,3,4,22,51,25,98,839,930,90,1858,98,112,216,2071,1401,40,3514
1011,3,19,0,0,0,19,39,9,66,563,419,53,1039,67,62,129,1167,712,21,1903
1012,0,13,0,0,0,8,15,3,32,201,259,21,484,36,20,61,538,495,7,1046
1013,3,6,0,0,0,6,18,11,32,315,264,38,621,37,46,82,703,452,18,1171
1014,0,3,0,0,0,6,13,3,28,234,208,14,456,38,47,93,549,549,14,1109
1015,0,7,0,0,0,8,18,9,33,242,151,12,405,18,19,36,443,285,22,749
1016,3,4,3,0,3,4,30,10,43,157,206,22,379,40,24,65,446,541,19,1006
1017,0,6,0,0,3,10,15,8,32,443,426,49,918,54,60,110,1025,722,16,1769
1018,0,0,0,0,0,0,11,4,17,113,152,14,280,19,23,42,324,349,12,688
1019,0,7,0,0,0,9,12,9,21,269,235,29,544,39,31,68,609,425,13,1051
1020,0,0,0,0,0,0,3,3,9,133,121,10,262,6,17,30,290,200,17,505
1021,0,3,0,0,0,7,19,7,32,151,105,15,268,48,21,74,338,310,8,654
1022,5,3,0,0,0,3,9,0,16,284,288,35,599,30,33,64,663,407,7,1079
1023,26,106,15,15,26,135,213,104,450,6065,5209,580,11850,722,662,1387,13237,9545,227,23007
1024,5,17,0,0,0,17,26,12,58,417,426,49,895,50,52,104,997,858,22,1888
1025,3,11,0,0,0,12,30,19,59,557,374,46,982,67,69,137,1115,726,29,1876
1026,0,0,0,3,0,5,12,0,18,132,106,11,250,17,21,41,286,258,11,551
1027,5,17,0,0,0,23,19,15,56,563,551,58,1170,45,63,113,1281,805,20,2109
1028,0,3,0,0,0,3,9,0,13,189,176,22,385,28,25,54,445,251,8,699
1029,3,5,0,0,0,5,18,3,31,151,239,21,412,27,24,56,469,403,18,892
1030,237,887,50,53,103,991,1389,915,3291,53689,32523,3959,90168,3708,4216,7923,98089,71528,1779,171402
1031,3,14,4,4,8,17,29,19,68,565,481,69,1115,76,77,159,1272,937,25,2237
1032,4,12,3,0,3,12,32,18,64,245,313,33,589,65,65,128,719,814,29,1557
1033,0,3,0,0,0,3,10,3,17,133,185,14,332,19,18,35,373,286,11,670
1034,7,16,4,0,4,19,42,25,82,785,495,65,1346,75,66,145,1489,977,44,2508
1035,17,71,6,12,13,87,134,52,273,3579,3003,322,6906,364,353,713,7620,5615,124,13360
2000,52,155,12,18,35,187,331,155,676,5572,6273,723,12571,628,616,1243,13814,10033,358,24208
2001,0,3,0,0,0,3,12,6,17,267,218,23,509,24,18,42,548,374,14,934
2002,0,0,0,0,0,4,6,8,17,149,179,27,353,14,23,40,390,283,10,685
2003,8,32,4,4,8,39,54,26,117,1175,1190,122,2482,142,200,345,2825,1894,51,4775
2004,3,28,0,0,3,32,52,16,96,1149,1235,143,2525,122,148,269,2796,1863,37,4696
2005,0,0,0,0,0,3,7,5,17,107,158,15,276,12,15,28,301,239,11,547
2006,0,4,0,0,0,4,14,11,28,216,214,23,450,19,18,41,491,287,11,793
2007,12,62,5,7,15,76,108,68,251,2826,2831,299,5963,305,292,592,6551,4106,112,10773
2008,0,3,0,0,0,3,4,3,12,191,181,17,387,11,5,19,406,157,3,570
2009,0,7,0,0,0,7,8,5,20,166,178,13,364,17,30,46,404,299,6,715
2010,242,1040,65,74,142,1179,1484,907,3567,49361,36912,4166,90440,4061,4274,8337,98772,67101,1811,167682
2011,3,17,0,5,9,27,44,23,89,810,637,88,1533,124,140,264,1794,1608,40,3447
2012,7,16,3,3,7,19,48,23,95,572,525,48,1145,70,73,141,1286,1020,43,2347
2013,0,3,0,0,0,4,20,10,42,176,215,21,421,47,34,82,506,474,20,1000
2014,3,3,0,0,0,3,5,0,11,126,127,15,271,17,20,35,297,210,3,518
2015,0,12,0,0,0,11,5,12,24,157,172,16,345,23,15,35,386,258,8,653
2016,9,26,3,0,3,27,30,20,80,594,564,82,1233,62,87,145,1378,966,28,2378
2017,0,0,0,3,3,3,7,8,14,117,122,7,247,10,15,21,266,176,6,455
2018,4,12,3,3,3,16,21,17,50,448,490,60,998,103,107,206,1199,861,30,2094
2019,0,5,0,0,0,5,17,16,39,189,243,20,457,29,26,60,514,372,17,909
2020,0,5,0,0,0,5,16,3,29,368,367,54,790,32,40,75,865,580,16,1460
2021,4,10,0,0,3,15,11,15,41,346,448,48,838,29,38,62,902,520,28,1452
3000,54,189,22,11,35,222,351,250,821,6613,5839,771,13223,1310,865,2178,15401,12544,451,28393
3001,134,475,44,41,91,568,599,436,1605,30481,19343,2363,52181,3212,2638,5844,58028,34080,870,92977
3002,6,11,3,3,8,21,33,27,90,736,725,74,1533,208,133,342,1871,1567,45,3482
3003,16,51,7,0,7,54,87,48,195,2248,1687,190,4117,308,247,550,4669,2499,85,7259
3004,3,3,0,0,0,6,3,3,7,149,87,9,248,24,13,42,290,116,3,406
3005,0,7,5,4,7,17,7,16,41,500,341,39,878,156,81,230,1111,610,16,1741
3006,58,170,6,10,11,183,194,121,501,8447,7245,763,16452,777,886,1664,18114,9983,253,28357
3007,0,3,0,0,0,7,9,7,27,235,275,25,529,58,49,111,638,632,18,1290
3008,10,13,3,3,4,22,27,14,64,502,575,56,1136,125,100,218,1357,1212,24,2591
3009,0,0,0,0,0,3,9,3,11,104,137,13,254,18,27,43,300,238,12,545
3010,10,31,5,0,3,35,44,16,89,1011,721,83,1816,206,162,369,2182,1204,28,3416
3011,0,3,0,3,3,5,13,14,33,229,253,32,515,78,46,128,640,731,22,1397
3012,0,7,0,0,0,7,14,8,24,295,97,22,415,37,24,62,478,289,9,770
3013,3,14,3,4,8,25,28,26,79,1036,794,92,1919,198,148,347,2267,1501,34,3802
3014,17,87,3,3,5,93,94,48,237,3604,3875,345,7823,358,421,778,8598,4396,107,13098
3015,3,28,0,0,0,29,46,21,92,1611,1301,124,3035,192,170,361,3397,2130,44,5568
3016,10,40,8,3,13,54,64,31,148,2685,1601,211,4504,425,282,706,5208,2908,62,8173
3017,3,12,0,0,0,12,10,4,21,174,192,27,391,35,35,67,450,337,10,797
3018,0,3,0,0,0,3,4,5,10,202,193,26,416,38,28,66,480,222,3,707
4000,14,64,5,4,15,73,99,66,244,2155,2229,248,4629,302,231,539,5169,3399,125,8690
4001,65,262,22,24,40,307,475,293,1079,16114,13896,1458,31470,1742,1590,3335,34801,22610,522,57939
4002,0,5,0,0,0,6,16,17,30,336,378,23,736,51,35,85,816,506,16,1346
4003,0,0,0,0,0,3,15,7,26,182,203,24,414,51,34,86,498,387,13,903
4004,0,3,0,0,0,3,26,21,48,147,138,25,309,28,25,47,364,330,22,713
4005,0,3,0,0,0,5,18,0,28,152,171,20,336,24,24,47,384,262,11,655
4006,0,5,0,0,0,5,12,3,22,141,179,14,328,28,34,66,402,378,6,779
4007,3,12,0,3,0,10,4,7,26,162,270,23,457,23,27,44,496,407,10,912
4008,0,5,0,0,0,7,23,15,48,222,239,25,498,71,50,119,613,555,29,1194
5000,14,55,7,7,17,73,147,124,340,2214,1980,290,4491,382,308,686,5175,3778,211,9159
5001,3,10,0,0,0,10,16,4,29,325,401,35,759,34,32,65,822,499,7,1333
5002,3,8,0,0,0,13,10,16,35,190,100,14,301,19,20,38,338,215,23,577
5003,3,11,0,3,4,15,23,10,57,853,849,87,1791,116,118,236,2029,1065,37,3125
5004,0,3,0,0,0,3,12,9,20,348,416,37,809,40,53,87,894,421,14,1329
5005,0,3,0,0,0,3,7,7,19,114,120,10,244,16,4,20,268,166,17,452
5006,0,4,0,0,0,7,29,19,56,475,396,44,915,85,63,146,1057,639,30,1725
5007,0,7,0,5,5,14,10,6,31,378,186,27,587,42,27,65,655,323,18,995
5008,0,3,0,0,0,3,11,7,13,171,44,15,225,23,5,27,254,136,9,402
5009,100,354,41,23,61,416,492,340,1242,22818,17496,1906,42224,2799,2348,5152,47377,25346,668,73391
5010,0,0,4,0,4,4,11,3,14,123,48,12,189,15,5,22,207,146,3,366
5011,3,4,0,0,0,6,4,3,12,128,103,21,250,14,22,42,295,196,3,492
6000,7,33,7,4,4,36,57,38,138,1191,1402,182,2770,184,165,350,3119,2507,92,5725
6001,0,3,0,0,0,6,20,7,35,304,308,39,655,57,49,111,765,626,12,1409
6002,0,13,0,4,4,10,24,8,45,335,378,47,755,44,54,101,854,725,18,1602
6003,10,42,3,7,10,56,84,44,182,2770,2590,271,5632,211,258,472,6104,3798,87,9982
6004,3,26,0,0,3,30,37,21,93,1007,1038,120,2168,126,114,234,2404,1585,44,4028
6005,0,3,0,0,0,7,9,3,16,161,170,20,348,22,23,41,391,283,9,678
7000,8,49,13,11,20,65,122,101,293,769,375,109,1247,217,95,310,1558,1715,145,3415
7001,3,4,0,0,0,4,11,19,32,421,148,35,602,20,16,38,639,268,23,928
7002,12,35,0,0,3,41,43,41,128,1910,632,144,2690,120,69,189,2876,1268,67,4212
8000,0,0,0,0,0,0,0,0,0,12,0,0,16,0,0,0,16,6,0,17
8001,12,60,0,0,0,64,79,41,181,6855,2948,473,10282,286,245,532,10812,4785,103,15697
9000,0,0,0,0,0,3,3,3,9,53,27,7,92,0,3,6,95,43,4,145