SA4_CODE_2016,All_inc_NS_Emp_AW,All_inc_NS_E_T,All_inc_NS_UnE_lfw_FTW,All_inc_NS_UnE_lfw_PTW,All_inc_NS_UnE_lfw_Tot,All_inc_NS_T_LF,All_inc_NS_Notin_LF,All_inc_NS_LF_sta_NS,All_inc_NS_Tot,Tot_Emp_WFT,Tot_Emp_WPT,Tot_Emp_AW,Tot_E_T,Tot_UnE_lfw_FTW,Tot_UnE_lfw_PTW,Tot_UnE_lfw_Tot,Tot_T_LF,Tot_Notin_LF,Tot_LF_sta_NS,Tot_Tot
101,20,60,6,0,13,73,97,55,223,2499,2025,267,4795,217,205,424,5222,3253,116,8589
102,25,92,3,16,17,110,144,97,345,4518,3990,441,8944,471,483,954,9900,6788,177,16863
103,15,56,8,6,16,64,142,75,279,2266,1844,226,4337,299,277,583,4918,3825,146,8879
104,5,29,7,3,9,44,92,39,170,1483,1675,157,3315,207,228,439,3751,2963,85,6800
105,15,52,13,7,16,72,141,75,282,1380,1103,164,2651,241,187,431,3082,2581,129,5786
106,15,69,10,11,14,84,152,64,299,3055,2790,345,6194,461,401,869,7060,5162,128,12349
107,17,71,6,12,13,87,134,52,273,3650,3063,335,7044,367,351,724,7764,5690,126,13577
108,25,72,9,8,18,90,167,68,328,2019,2422,255,4694,330,326,659,5346,4883,147,10374
109,7,31,0,5,3,34,73,35,147,1148,1116,153,2415,144,147,288,2704,1783,64,4548
110,12,60,11,9,20,81,136,79,293,1978,1697,227,3900,314,267,586,4480,3668,126,8280
111,17,71,9,6,21,85,139,77,304,4651,3933,420,9005,494,457,950,9959,6973,176,17101
112,18,65,9,6,14,80,132,73,281,2676,3264,330,6264,326,354,683,6946,4802,137,11888
113,12,40,5,0,3,46,105,64,212,1820,1330,151,3305,193,146,342,3641,2593,117,6351
114,11,45,0,0,0,49,83,31,159,1463,1585,157,3211,150,158,308,3516,2734,79,6328
115,6,37,0,3,0,41,25,23,89,2578,1373,137,4095,119,111,231,4323,2059,55,6440
116,24,89,11,5,18,107,200,120,433,4742,2545,410,7693,485,466,952,8642,7199,225,16065
117,13,40,3,0,3,42,69,48,159,2572,1428,192,4193,172,185,352,4549,3407,94,8052
118,10,52,6,0,6,52,55,27,144,2895,1747,190,4832,128,143,271,5100,2835,71,8011
119,34,112,9,7,15,128,190,132,452,6462,4438,587,11483,544,709,1256,12741,11609,274,24621
120,14,47,0,3,3,44,49,35,126,3472,1933,220,5626,177,204,382,6005,3925,79,10003
121,20,64,0,0,0,67,46,25,138,4704,2500,251,7458,199,200,395,7854,4149,52,12055
122,18,58,0,3,5,68,53,20,136,3030,2000,177,5209,119,96,214,5428,2403,57,7884
123,21,82,5,3,9,89,119,102,311,4112,2487,325,6927,375,388,761,7685,5232,160,13085
124,29,98,3,4,8,107,117,71,295,5106,3225,399,8733,332,350,683,9417,5577,130,15126
125,18,58,4,7,16,69,162,106,338,4659,2825,390,7874,391,451,846,8715,8199,204,17126
126,10,32,0,0,0,37,30,9,72,2031,1141,113,3282,81,99,178,3463,2238,37,5737
127,24,73,6,10,17,90,230,174,497,4839,3312,427,8579,523,724,1244,9819,10882,305,21012
128,9,67,4,0,6,71,39,18,135,3062,1994,191,5248,116,139,251,5505,2411,47,7960
197,0,0,0,0,0,0,0,0,0,0,0,0,0,0,0,0,0,0,0,0
199,0,0,0,0,0,0,0,0,0,0,0,0,0,0,0,0,0,0,0,0
201,9,40,7,4,14,47,82,46,176,1580,1702,182,3459,203,279,483,3945,2917,86,6945
202,11,41,4,0,3,48,72,25,142,1649,1800,189,3636,174,191,366,4002,2749,69,6826
203,20,73,7,10,13,90,123,72,288,3095,3089,324,6512,325,316,641,7152,4484,129,11767
204,13,40,0,6,3,51,79,52,179,1751,1836,209,3793,202,178,379,4173,2665,94,6926
205,22,67,6,5,14,83,144,70,296,2453,2919,358,5726,385,381,766,6488,4742,146,11382
206,22,80,0,4,11,94,171,87,348,4534,3171,336,8039,376,418,795,8832,6775,171,15776
207,17,49,3,0,11,56,73,54,178,3779,2751,261,6795,235,237,475,7271,4822,110,12198
208,18,86,0,0,3,91,85,53,229,4680,3423,326,8430,256,261,516,8949,4706,106,13766
209,27,134,9,13,26,160,210,108,472,5851,4537,504,10895,442,461,903,11797,8243,199,20235
210,20,98,7,6,13,113,168,98,385,4139,3107,411,7650,378,372,743,8395,7054,210,15660
211,45,180,3,3,13,184,151,75,415,6637,5331,520,12490,324,418,744,13233,6799,157,20190
212,46,173,20,16,36,206,242,184,632,8801,6416,794,16010,802,834,1638,17643,12931,359,30938
213,40,189,11,21,34,219,343,218,786,8877,6176,836,15891,1135,1104,2234,18130,13799,426,32352
214,24,95,5,6,12,106,133,79,320,3916,3627,377,7924,320,379,695,8615,4868,160,13653
215,7,35,3,6,11,43,99,56,196,1366,1327,141,2829,154,151,306,3139,2617,101,5860
216,18,37,3,5,9,47,79,42,168,1307,1309,170,2780,153,166,321,3106,2235,82,5428
217,12,33,5,3,4,41,65,41,146,1103,1330,146,2579,99,116,216,2793,1828,79,4699
297,0,0,0,0,0,0,0,0,0,0,0,0,0,0,0,0,0,0,0,0
299,0,0,0,0,0,0,0,0,0,0,0,0,0,0,0,0,0,0,0,0
301,23,58,3,8,4,66,62,39,164,3548,2233,235,6014,248,231,471,6487,3125,84,9692
302,6,35,0,0,4,40,47,49,135,3130,1781,232,5138,195,193,388,5526,2938,87,8556
303,16,63,7,3,9,74,65,43,180,4184,2541,314,7038,360,296,655,7687,4580,111,12379
304,3,26,3,4,3,36,17,12,61,2292,1345,138,3773,144,110,254,4030,1766,37,5833
305,9,26,3,0,4,26,30,13,74,2683,1396,152,4229,154,127,284,4517,1877,29,6428
306,19,76,6,0,8,81,146,77,311,3249,2562,301,6110,511,378,893,7002,4349,148,11494
307,8,37,6,3,10,40,56,36,131,1138,968,137,2247,183,144,332,2573,2020,61,4661
308,15,50,6,8,17,68,70,66,199,2435,1838,226,4495,530,346,879,5377,3335,101,8819
309,54,157,6,3,11,172,169,99,439,7795,6486,683,14961,711,803,1511,16481,8829,221,25530
310,24,79,17,8,23,103,126,102,329,4663,3063,398,8130,767,539,1307,9432,6915,193,16543
311,24,92,13,7,22,116,129,109,354,4684,3183,409,8276,729,567,1296,9571,6827,194,16591
312,22,60,3,0,8,63,54,33,152,1857,1354,173,3382,354,245,600,3979,2155,68,6208
313,19,73,6,11,16,92,114,66,272,3065,2549,343,5960,493,453,947,6910,5153,118,12181
314,14,42,0,0,3,51,45,20,112,2928,1939,234,5100,256,228,486,5586,2477,58,8118
315,4,27,0,3,4,32,63,50,145,945,514,93,1561,160,86,248,1808,1626,82,3515
316,22,99,3,3,5,104,107,52,264,3972,4354,389,8711,399,464,869,9578,5016,114,14712
317,8,34,0,0,0,32,59,28,120,1789,1438,149,3373,224,187,409,3786,2443,50,6284
318,14,54,7,4,15,71,85,52,209,3167,2037,273,5469,529,361,893,6362,3848,98,10309
319,25,57,11,18,30,80,157,102,346,2514,2734,281,5530,720,485,1199,6735,6528,196,13449
397,0,0,0,0,0,0,0,0,0,0,0,0,0,0,0,0,0,0,0,0
399,0,0,0,0,0,0,0,0,0,0,0,0,0,0,0,0,0,0,0,0
401,8,47,0,6,6,52,46,29,127,3253,2523,243,6023,191,206,396,6420,3269,75,9760
402,31,105,13,15,24,134,215,127,478,5564,4965,552,11083,869,737,1607,12690,9400,217,22312
403,13,68,5,8,11,75,110,87,273,4587,4231,443,9262,441,403,842,10103,5630,137,15866
404,9,50,4,3,3,54,109,52,216,2859,2330,236,5424,251,256,510,5935,4451,101,10487
405,0,16,0,3,4,19,49,12,83,920,1007,104,2035,149,137,285,2314,1719,38,4073
406,10,28,7,0,3,32,92,70,190,773,768,114,1654,157,118,278,1936,1496,89,3524
407,9,50,5,6,15,70,71,53,198,1651,1884,168,3699,254,198,453,4154,2866,91,7112
497,0,0,0,0,0,0,0,0,0,0,0,0,0,0,0,0,0,0,0,0
499,0,0,0,0,0,0,0,0,0,0,0,0,0,0,0,0,0,0,0,0
501,6,24,0,3,5,31,60,30,122,1752,1944,228,3921,244,253,494,4416,2368,78,6867
502,7,21,4,0,4,27,39,15,84,965,975,122,2064,189,164,353,2416,1768,35,4219
503,3,19,0,0,0,15,24,5,46,1438,1032,94,2569,110,122,239,2803,1365,21,4196
504,9,39,7,0,8,46,81,60,184,3483,2479,254,6221,394,312,708,6929,3614,104,10646
505,40,114,14,12,20,134,127,96,353,6624,5160,587,12375,751,638,1397,13771,6745,182,20699
506,20,88,5,5,11,102,118,105,321,5687,4188,469,10347,739,628,1368,11716,6702,201,18617
507,20,82,9,6,13,94,112,64,273,4963,3922,412,9301,655,527,1178,10484,5572,140,16188
509,11,26,3,3,5,36,65,35,135,1094,1147,129,2368,159,141,299,2665,1881,78,4623
510,4,23,3,3,6,23,67,57,148,857,369,87,1308,131,83,217,1527,1264,79,2876
511,7,39,3,7,8,42,73,76,189,1284,904,125,2317,204,129,334,2647,1666,117,4428
597,0,0,0,0,0,0,0,0,0,0,0,0,0,0,0,0,0,0,0,0
599,0,0,0,0,0,0,0,0,0,0,0,0,0,0,0,0,0,0,0,0
601,10,48,3,10,11,56,93,45,200,2977,2832,305,6121,233,282,514,6636,4148,100,10877
602,10,28,8,3,6,40,56,31,128,1398,1547,183,3130,199,177,378,3507,2543,70,6118
603,0,6,0,0,0,6,15,7,29,282,315,41,636,32,42,67,706,634,21,1362
604,8,37,0,3,4,37,68,40,153,1117,1183,153,2453,185,161,340,2795,2192,76,5059
697,0,0,0,0,0,0,0,0,0,0,0,0,0,0,0,0,0,0,0,0
699,0,0,0,0,0,0,0,0,0,0,0,0,0,0,0,0,0,0,0,0
701,12,36,0,0,3,38,49,48,137,2095,692,172,2953,129,78,205,3164,1359,75,4605
702,8,56,13,11,20,76,127,116,317,998,460,126,1586,228,100,330,1909,1890,156,3960
797,0,0,0,0,0,0,0,0,0,0,0,0,0,0,0,0,0,0,0,0
799,0,0,0,0,0,0,0,0,0,0,0,0,0,0,0,0,0,0,0,0
801,8,51,0,0,0,51,68,32,154,6171,2687,425,9275,261,212,472,9748,4295,88,14129
897,0,0,0,0,0,0,0,0,0,0,0,0,0,0,0,0,0,0,0,0
899,0,0,0,0,0,0,0,0,0,0,0,0,0,0,0,0,0,0,0,0
901,0,0,0,0,0,3,3,3,9,53,27,7,92,0,3,6,95,43,4,145
997,0,0,0,0,0,0,0,0,0,0,0,0,0,0,0,0,0,0,0,0
999,0,0,0,0,0,0,0,0,0,0,0,0,0,0,0,0,0,0,0,0